###########################
#JMM####MMMMMMMMBMM####MMC#
#M#MMMMMM####D####MMMMMM#M#
#M#####M###BMMMM#####M###M#
#MMMMMMMMMDM#C#MDMMMMMMMMM#
#######D###M###M#M####A####
#MMMMMMMMMDM#C#MDMMMMMMOMM#
#A####MM#M#MMMMM#M#D#####D#
#MMMMM#M#M#######M#MMMMMMM#
##C##M#MBMMMMDMMMM#M#M##C##
###########################
